##          ##
##          ##     SCORE
##          ##    #######
##          ##    #     #
##          ##    #######
##          ##
##          ##     LEVEL
##          ##    #######
##          ##    #     #
##          ##    #######
##          ##
##          ##     LINES
##          ##    #######
##          ##    #     #
##          ##    #######
##          ##
##          ##    ########
##          ##    #      #
##          ##    #      #
##          ##    #      #
##############    #      #
##############    ########